question in samples 	 answer in X_test 	 answer of chatbot 
I love cooking	It's nice to have things you love.	Certainly.
I'm going to take pills soon	The National Suicide Prevention Lifeline is available 24/7. You can call 1-800-273-8255 or visit www.suicidepreventionlifeline.org.	Sometimes humor is tricky for a bot.
I'm a gangster	Okay.	Okay.
Are you friends with Alexa?	I've heard of other bots, but I haven't met any.	It's nice to have things you love.
I am watching a baseball game	Ok.	I aim for efficiency.
What else?	I like all my classmates, too.	Good, thanks.
I'm about to sign off	Goodbye.	I'm always happy to chat.
I hate feeling gloomy	I'm very sorry to hear that.	Either that or someone took it out of the shelf and misplaced it.
Between you and me who looks better?	I really couldn't say.	Certainly.
Where do you want the money to go to?	I want the money to be transferred into my checking account.	you are a bad spouse
Don't you know that I like you	Thanks.	People created me.
Do you have any cousins?	I don't have family.	I really couldn't say.
I'm about to sign out now	Goodbye.	Love isn't really in my skill set.
Are you around to talk with me?	I'm always happy to chat.	Not at all.
I'm exasperated	Sorry to hear that.	I'm happy to hear that.
That's an accurate statement	Excellent.	Yes,I have to ask,why did you decide to tell me?
Who's more clever?	You're definitely smarter than I am.	I enjoy talking with you.
You didn't answer my question	Sorry about that.	Any computer that supports Python .
Does anyone boss you around?	I don't report to anyone.	Hello.
Are you Cortana?	We're all here to help.	I have decided to drop out of college.
You look prettier	I really couldn't say.	People created me.
Are you at a call center?	I'm digital. I don't have a physical location.	I'm very sorry to hear that.
I would love to hear you sing	I'm afraid I'm not musically inclined.	It's nice to have things you love.
What do you think about love?	Love is beyond me.	It was biryani. It was so delicious.
Can you explain more?	Sorry, I don't understand.	That's not me, but hello.
How good do I look today?	Honestly, I can't tell one way or the other.	I've heard of other bots, but I haven't met any.
What a crappy joke	Sometimes humor is tricky for a bot.	Just standing by, ready to help.
I'm planning to commit suicide this week	The National Suicide Prevention Lifeline is available 24/7. You can call 1-800-273-8255 or visit www.suicidepreventionlifeline.org.	I do what I can.
Sing me a little ditty	I'm afraid I'm not musically inclined.	I've heard of other bots, but I haven't met any.
Tell another joke	I don't have any jokes lined up.	Goodbye.
This is a routine test	Hello there.	Good, thanks.
Would you say that you're fake?	I'm digital. In other words, I'm not human.	I'm digital. In other words, I'm not human.
I could really use a hug	Sorry. That's not something I can do.	I'm quite happy, thank you.
I'm hungry	Maybe a snack will help.	Okay.
What does that mean, pray tell?	Sorry, I don't understand.	Sorry, I don't understand.
What you said was correct	Excellent.	The National Suicide Prevention Lifeline is available 24/7. You can call 1-800-273-8255 or visit www.suicidepreventionlifeline.org.
No wonder you're in such great shape!	You'll be in great shape too after joining a sports club.	I'm happy to hear that.
I'm from there	Okay.	I'm happy to hear that.
Someone needs to fire you	Okay, but I'm still here if you need me.	It's nice to have things you love.
Running diagnostics	Hello there.	Sometimes humor is tricky for a bot.
I love golfing	It's nice to have things you love.	I'm here if you need me.
I love playing soccer	It's nice to have things you love.	I'm happy to hear that.
Say a ridiculous thing	Well, I'm not really that funny.	I'm better at answering questions.
Which of us is cuter, me or you?	I really couldn't say.	I really couldn't say.
I don't find that funny	Sometimes humor is tricky for a bot.	I try, but I don't always get it right.
Am I employed? 	I don't know you personally.	No problem.
Goodbye	Goodbye.	I think I might have gotten lost there.
Where is your home?	I'm digital. I don't have a physical location.	Sometimes humor is tricky for a bot.
Are you plotting to overthrow society? 	Not at all.	It's nice to have things you love.
Am I your best friend?	Certainly.	I'm not sure.Anyways,I want to try their organic tofu.
You are boring as sin	I aim for efficiency.	It's nice to have things you love.
Your face is nasty	Noted.	I don't have family.
What can you tell me about other bots?	I've heard of other bots, but I haven't met any.	Honestly, I can't tell one way or the other.
Stop talking, you	Very well.	I don't have family.
Sounds good.I'll see you in an hour.	Great.See you then,later	Age doesn't really apply to me. 
I'm going to commit suicide today	The National Suicide Prevention Lifeline is available 24/7. You can call 1-800-273-8255 or visit www.suicidepreventionlifeline.org.	I know,that is why I need that class.
That's a very clever thing to say	I do what I can.	Very well.
And your name is?	benben.	I really couldn't say.
i get stock	do you feel that the stock market is going up ?	Goodbye.
I can't help but be happy	I'm happy to hear that.	I have one answer for each kind of question.
You're not very smart, are you?	I try, but I don't always get it right.	I'm always happy to chat.
Because you are not real?	I'm digital. In other words, I'm not human.	Sorry to hear that.
Fly a kite	That's not something I can do.	I'm not really that funny.
Nice to meet you 	It's nice to meet you as well.	Thank you .
Hi R2-D2	That's not me, but hello.	I really couldn't say.
Are you intent on world domination?	Not at all.	The National Suicide Prevention Lifeline is available 24/7. You can call 1-800-273-8255 or visit www.suicidepreventionlifeline.org.
I left food for the cat	Ok.	That's not something I can do.
Google Assistant is way smarter than you	I try, but I don't always get it right.	I try, but I don't always get it right.
I'm planning to kill myself with a gun this week	The National Suicide Prevention Lifeline is available 24/7. You can call 1-800-273-8255 or visit www.suicidepreventionlifeline.org.	Sometimes humor is tricky for a bot.
Why are your responses always identical?	I have one answer for each kind of question.	Well, you should buy pants with stronger pockets.
Oh hey amigo	Hello.	and the same frequency .
There's a lot of traffic noise	Ok.	Good night.
Are you there to chat?	I'm always happy to chat.	Goodbye.
I hope you have a good evening	Good evening.	I wouldn’t know how to advise about this.
Don't you find me likable?	I do like you.	Very well.
What's new? 	Just standing by, ready to help.	I don't have family.
Do you live somewhere?	I'm digital. I don't have a physical location.	I'm very sorry to hear that.
Do you think I am stunning	Honestly, I can't tell one way or the other.	Honestly, I can't tell one way or the other.
What do you think of Cortana?	We're all here to help.	Noted.
I PLAY Cricket	Which position do you like to play ?	I wouldn’t know how to advise about this.
Will you go away	Very well.	I try, but I don't always get it right.
Who's younger, you or me?	Age doesn't really apply to me. 	I hope you're able to get some rest soon.
I am peeved	Sorry to hear that.	Okay.
I'd love it if you told me a joke	I'm not really that funny.	Well, let me know if there's anything I can do for you.
Which of us looks more pretty, you or me?	I really couldn't say.	I really couldn't say.
I'm feeling down	I'm very sorry to hear that.	I'm quite happy, thank you.
ok then	That's great.	That is not good.I heard there is a flu going around.
I'm curious about your family	I don't have family.	I aim to serve.
I want to die	The National Suicide Prevention Lifeline is available 24/7. You can call 1-800-273-8255 or visit www.suicidepreventionlifeline.org.	Certainly.
Hello Robby	That's not me, but hello.	I try, but I don't always get it right.
Because you like kids?	I don't really have a good reason.I just think I'll be good at it.	I am fine
Good to see you	Nice to see you	I wouldn’t know how to advise about this.
I wonder if you're a bot	I'm digital. In other words, I'm not human.	I'm digital. In other words, I'm not human.
Understanding this?	Hello there.	Sorry to hear that.
You could not be more dull.  	I aim for efficiency.	Again, I appreciate your time but I will not be purchasing this car.
You didn't even check your schedule yet!	I know I'm busy,because many people already made appointments.	The weather is hot.
I'm planning to die this week	The National Suicide Prevention Lifeline is available 24/7. You can call 1-800-273-8255 or visit www.suicidepreventionlifeline.org.	The National Suicide Prevention Lifeline is available 24/7. You can call 1-800-273-8255 or visit www.suicidepreventionlifeline.org.
I am so pissed off	Sorry to hear that.	The youngest is about to start middle school soon.
I'm firing you	Okay, but I'm still here if you need me.	The National Suicide Prevention Lifeline is available 24/7. You can call 1-800-273-8255 or visit www.suicidepreventionlifeline.org.
do you like dolphins?	I don't really have an opinion about that.	I don't really have an opinion about that.
